любить	VERB	OmegaWiki	чувствовать аффективную привязанность к кому-то
прямоугольник	NOUN	OmegaWiki	Плоская фигура с 4 боками и 4 прямыми углами.
ассоциировать	VERB	OmegaWiki	ставить вместе, строить какие-то органические отнощения
ноябрь	NOUN	OmegaWiki	Одиннадцатый месяц Григорианского календаря, с 30 днями.
Порт-о-Пренс	NOUN	OmegaWiki	Столица и самый большой город Гаити.
дамаск	NOUN	OmegaWiki	Столица Сирии.
дедушка_со_стороны_отца	NOUN	OmegaWiki	Мать чей-то отец.
дедушка_со_стороны_отца	NOUN	OmegaWiki	Мать чей-то мать.
дедушка_со_стороны_отца	NOUN	OmegaWiki	Отец чей-то отец.
дедушка_со_стороны_отца	NOUN	OmegaWiki	Отец чей-то мать.
немецкий	NOUN	OmegaWiki	Индоевропейский язык, на котором говорят главным образом в Германии, Австрии, Лихтенштейне, Южном Тироле, Швейцарии и небольшой части Бельгии.
фараон	NOUN	OmegaWiki	Верховный правитель древнего Египта.
Кабул	NOUN	OmegaWiki	Столица Афганистана.
март	NOUN	OmegaWiki	Третьий месяц Григорианского календаря, с 31 днями.
Сент-Джонс	NOUN	OmegaWiki	Столица и крупнейший город Антигуа и Барбуды.
Луанда	NOUN	OmegaWiki	Столица и крупнейший город Анголы.
директор-распорядитель	NOUN	OmegaWiki	глава совета правления в фирмах и т.п.
Беларусь	NOUN	OmegaWiki	Государство в Восточной Европе.
соответствующий	ADJ	OmegaWiki	что идентично  чему-то другому
национальная_граница	NOUN	OmegaWiki	граница во времени иили пространстве и т.п.
приспособить	VERB	OmegaWiki	намеренно изменить пропорции чего-то, чтобы объект подходил к чему-нибудь
приспособить	VERB	OmegaWiki	изменить товар, чтобы он был таким, каким он нужен клиентам
Германия	NOUN	OmegaWiki	Центральноевропейская страна со столицей в Берлине.
август	NOUN	OmegaWiki	Восьмой месяц Григорианского календаря, с 31 днями.
абитуриент	NOUN	OmegaWiki	Человек кто обращается к университет или колледж.
подражать	VERB	OmegaWiki	Воспроизводить кого-то поведение или внешность.
Бежа	NOUN	OmegaWiki	Округ Португалии, расположен на юге.
церковь	NOUN	OmegaWiki	Здание, где христианская религиозная деятельность осуществляется.
диалектический_материализм	NOUN	OmegaWiki	Понятие бытия что все материальные вещи вызваны потому что есть раздор среди несовместимых властей, звеньев, и мнений.
век	NOUN	OmegaWiki	Отрезок времени, равный 100 годам.
марсианин	NOUN	OmegaWiki	Житель Марса.
вы	NOUN	OmegaWiki	Группа людей которой говорят.
Андорра-ла-Велья	NOUN	OmegaWiki	Столица и крупнейший город Андорры.
позиция	NOUN	OmegaWiki	отнощение к кому-то или чему-то
мы	NOUN	OmegaWiki	Говорящий или пишущий и по меньшей мере один другой челове
все	NOUN	OmegaWiki	Каждый человек или что-нибудь данного класса, без исключения.
по-дружески	ADV	OmegaWiki	в дружеской манере
декабрь	NOUN	OmegaWiki	Двенадцатый месяц Григорианского календаря, с 31 днями.
самец	NOUN	OmegaWiki	Представитель пола, который производит детёнышей, оплодотворяя яйца.
теракт	NOUN	OmegaWiki	Попытка кому-то или чему-то повредить взрывом бомбы
Дилли	NOUN	OmegaWiki	Племянники Дональда Дака.
промышленное_предприятие	NOUN	OmegaWiki	Фирма, производящая чего-либо индустриальным путем
Луна	NOUN	OmegaWiki	Естественный спутник планеты.
Луна	NOUN	OmegaWiki	Единственный естественный спутник Земли.
Доха	NOUN	OmegaWiki	Столица Катара.
поручать	VERB	OmegaWiki	что-то кому-то доверять
Улан-Батор	NOUN	OmegaWiki	Столица Монголии.
регистр_земель_и_собственности	NOUN	OmegaWiki	Система регистрации земельных участков или имущественных интересов, связанных с ними. Описывает земельный участок и связанные с ним имущественные права, как, например, право прохода на соседние участки.
ял	NOUN	OmegaWiki	Маленькая лодка сделана чтобы грести с четырьмя или шестью вёслами.
где	ADV	OmegaWiki	В каком месте?
яйцо	NOUN	OmegaWiki	Женская половая клетка, превращающаяся в новый организм в результате оплодотворения.
шесть	NOUN	OmegaWiki	Количественное числительное после пяти и перед семью; в кириллической системе Ѕ и в арабской цифре 6.
устав	NOUN	OmegaWiki	правила касающие некой компании или ассоцияции, как указаны в акте ее создания.
баклажан	NOUN	OmegaWiki	Фиолетовый овальный овощ, плод растения "Solanum melongena".
прихожая	NOUN	OmegaWiki	ближайшее к входу помещение в квартире, офисе
объявлять	VERB	OmegaWiki	что-то сказать публичным заявлением
фары_дальнего_света	NOUN	OmegaWiki	фары автомобиля, дающие максимально  дальнее освещение дороги
атрибут	NOUN	OmegaWiki	характерная черта
расширение	NOUN	OmegaWiki	делать более большим, широким
латгалец	NOUN	OmegaWiki	Персона латгальской национальности.
Ереван	NOUN	OmegaWiki	Наибольший город и столица Армении.
признак	NOUN	OmegaWiki	характерная черта
Непал	NOUN	OmegaWiki	Страна в южной Азии, в Гималаях между Индией и Китаем (Тибет).
фунт_стерлингов	NOUN	OmegaWiki	Официальная валюта Соединённого Королевства Соединённого Королевства Великобритании и Северной Ирландии и некоторые территории, с символом «£».
гребень	NOUN	OmegaWiki	Тучный красный гребень петуха.
выборка	NOUN	OmegaWiki	в статистике. Часть, выбрана для того, чтобы показать поведение целого
мегрельский	NOUN	OmegaWiki	Южнокавказский язык, используемый в Грузии.
пригласить	VERB	OmegaWiki	Спросить за присутствие или участие кого-то.
женский	NOUN	OmegaWiki	Женский грамматический род слов.
Москва	NOUN	OmegaWiki	Капитал и наибольший город Россия.
батюшка	NOUN	OmegaWiki	Мужской родитель.
ФРГ	NOUN	OmegaWiki	Центральноевропейская страна со столицей в Берлине.
страх	NOUN	OmegaWiki	отрицательная эмоция в ситуации реальной или воображаемой опасности
безграмотность	NOUN	OmegaWiki	Неумение читать.
управляющий	NOUN	OmegaWiki	член совета правления в фирмах и т.п.
сицилийский	NOUN	OmegaWiki	Язык Сицилии.
сотрудничество	NOUN	OmegaWiki	Процесс который люди или организации работают вместе чтобы выполнять общее задание.
ремесленное_производитель	NOUN	OmegaWiki	Фирма, производящая чего-либо неиндустриальным путем
украинский	NOUN	OmegaWiki	Государственный язык Украины, относящийся к восточно-славянским языкам.
есть	VERB	OmegaWiki	Есть пищу.
краб	NOUN	OmegaWiki	Ракообразно с толстым экзоскелетом и парой клещи.
сербский	NOUN	OmegaWiki	Южнославянский язык, распространённый в Сербии, написание кириллицей
слепота	NOUN	OmegaWiki	Неспособность зрения.
особенность	NOUN	OmegaWiki	характерная черта
Амман	NOUN	OmegaWiki	Капитал Иордании.
удовлетворять	VERB	OmegaWiki	сделать то, что просят
рисунок	NOUN	OmegaWiki	детальное изображение человека или объекта
Эривань	NOUN	OmegaWiki	Наибольший город и столица Армении.
суринамский	NOUN	OmegaWiki	Креольский язык, на которых говорят в Суринаме.
воздерживаться_от	VERB	OmegaWiki	Контролировать своё эмоциям чтобы не делать что-то.
Катманду	NOUN	OmegaWiki	Столица Непала.
подходить	VERB	OmegaWiki	начать заниматься чем-то трудным
любоваться	VERB	OmegaWiki	рассматривать с восхищением
падре	NOUN	OmegaWiki	Мужской родитель.
бабушка_по_матери	NOUN	OmegaWiki	Мать чей-то отец.
бабушка_по_матери	NOUN	OmegaWiki	Мать чей-то мать.
бабушка_по_матери	NOUN	OmegaWiki	Отец чей-то мать.
бабушка_по_матери	NOUN	OmegaWiki	Отец чей-то отец.
аура	NOUN	OmegaWiki	атмосфера чего-либо, что создается вокруг одного человека
языковая_семья	NOUN	OmegaWiki	группа языков, которые развились из общего предка
Аддис-Абеба	NOUN	OmegaWiki	Капитал Эфиопии.
расстановка	NOUN	OmegaWiki	организация элементов создающих некий комплект
поедать	VERB	OmegaWiki	Поглощать что-либо твёрдое или полутвёрдое (обычно, еду), помещая в рот и затем, проглатывая.
луна	NOUN	OmegaWiki	Естественный спутник планеты.
луна	NOUN	OmegaWiki	Единственный естественный спутник Земли.
Зальцбург	NOUN	OmegaWiki	Федеральная земля Австрии.
выскочка	NOUN	OmegaWiki	Богатый человек чей богатство он недавно получил, и следовательно, он кажется отсутствовать культура их кто росли в богатстве.
ближний_свет	NOUN	OmegaWiki	фары автомобиля, дающие максимально  дальнее освещение дороги
сентябрь	NOUN	OmegaWiki	Девятый месяц Григорианского календаря, с 30 днями.
оленёнок	NOUN	OmegaWiki	Mолодой олень.
сближение	NOUN	OmegaWiki	смещение ближе к чему-то/кому-то 
Гаити	NOUN	OmegaWiki	Страна в Карибском море котором столица Порт-о-Пренс.
февраль	NOUN	OmegaWiki	Вторый месяц Григорианского календаря, с 29 днями в високосном году а 28 в других годах.
Бандар-Сери-Бегаван	NOUN	OmegaWiki	Столица султаната Брунея.
таки_таки	NOUN	OmegaWiki	Креольский язык, на которых говорят в Суринаме.
Билли,_Вилли,_Дилли	NOUN	OmegaWiki	Племянники Дональда Дака.
пополнение	NOUN	OmegaWiki	добавление или исправление данных, техники и т.п., согласно последней полученной информации
фирменный	ADJ	OmegaWiki	касающий фирмы
Билли	NOUN	OmegaWiki	Племянники Дональда Дака.
послепродажное_обслуживание	NOUN	OmegaWiki	услуги, оказываемые продавцом покупателю после сделанной им покупки
солнечное_затмение	NOUN	OmegaWiki	Астрономическое явление, которое заключается в том, что Луна полностью или частично закрывает Солнце от наблюдателя на Земле.
евроскептик	NOUN	OmegaWiki	Человек, у которого глубокие сомнения о целе и эффективносте Европейского союза.
бассейн	NOUN	OmegaWiki	Плавательный бассейн в здании.
граница	NOUN	OmegaWiki	граница во времени иили пространстве и т.п.
товарищ	NOUN	OmegaWiki	Товарищ, который оказывает помощь.
заводской	ADJ	OmegaWiki	касающий фирмы
книга	NOUN	OmegaWiki	Коллекция листах бумаги связаны друг с другом, чтобы петля на одном краю, содержащие печатные или письменные материалы, фотографии и т.д.
шар	NOUN	OmegaWiki	круглый трехмерный объект, все точки плоскости которого находятся в том же растоянии от него центра
Бланкенезе	NOUN	OmegaWiki	квартал в Гамбурге
Авраам	NOUN	OmegaWiki	Отец Исаака.
мучать	VERB	OmegaWiki	заставить кого-то чувствовать огорчение | повредить
качество	NOUN	OmegaWiki	характерная черта
литовский	NOUN	OmegaWiki	Балтийский язык говорят в основном в Литве.
воздержаться_от	VERB	OmegaWiki	Контролировать своё эмоциям чтобы не делать что-то.
каска	NOUN	OmegaWiki	защитный головной убор
опустошать	VERB	OmegaWiki	заставить кого-то чувствовать огорчение | повредить
хадж	NOUN	OmegaWiki	Паломничество в Мекку в исламе. Каждый физически здоровый мусульманин, располагающий необходимыми средствами обязан хотя бы один раз за свою жизнь совершить такое паломничество.
библиотека	NOUN	OmegaWiki	Место, где хранятся книги и другие написанные материалы.
успение_богородицы	NOUN	OmegaWiki	религиозный праздник
отношение	NOUN	OmegaWiki	рабочие отнощения согласно контракту
Португалия	NOUN	OmegaWiki	Страна в Европе со столицей в Лиссабоне.
сталелитейный_завод	NOUN	OmegaWiki	завод для производства стали
сапробионты	ADJ	OmegaWiki	Классификация живых организмов в зависимости от способности переносить органически загрязненную среду обитания
Земля	NOUN	OmegaWiki	Третья от Солнца планета Солнечной системы.
Белград	NOUN	OmegaWiki	Наибольший город и капитал Сербии.
засыпка_мусорной_ямы	NOUN	OmegaWiki	Разпределение различных материалов на поверхности мусора для снижения нежелательного воздействия на окружающую среду.
монгольский	NOUN	OmegaWiki	Официальный язык Монголии, тоже говорят в России.
исполнение	NOUN	OmegaWiki	процесс выполнения какого-то плана
шлем	NOUN	OmegaWiki	защитный головной убор
показ_до_премьеры	NOUN	OmegaWiki	о фильмах
склонность	NOUN	OmegaWiki	отнощение к кому-то или чему-то
отпраздновать_самого_себя	VERB	OmegaWiki	официально отпраздновать самого себя
куда	ADV	OmegaWiki	В какое место?
Веллингтон	NOUN	OmegaWiki	Столица Новой Зеландии.
выкидыш	NOUN	OmegaWiki	прерывание беременности
бхотия	NOUN	OmegaWiki	Язык Бутана, Индии и Непала.
собирать	VERB	OmegaWiki	строить чего-то из частей
Австралия	NOUN	OmegaWiki	Страна в Океании со столицей в Канберре.
тенденция	NOUN	OmegaWiki	отнощение к кому-то или чему-то
Плутон	NOUN	OmegaWiki	Планета-карлик в Солнечной системе, считавшаяся ранее девятой планетой.
усыновление	NOUN	OmegaWiki	юридический процесс принятия кого-либа лица  в свою семью на правах сына или дочки
аборт	NOUN	OmegaWiki	прерывание беременности
водородная_бомба	NOUN	OmegaWiki	Термоядерная бомба, в которой разрушающая сила получается за счёт слияния ядер изотопов водорода.
кооперация	NOUN	OmegaWiki	Процесс который люди или организации работают вместе чтобы выполнять общее задание.
бодрый	ADJ	OmegaWiki	Не спящий, бодрствующий.
июнь	NOUN	OmegaWiki	Шестый месяц Григорианского календаря, с 30 днями.
голубоватый	ADJ	OmegaWiki	Несколько синий.
июль	NOUN	OmegaWiki	Седьмый месяц Григорианского календаря, с 31 днями.
парвеню	NOUN	OmegaWiki	Богатый человек чей богатство он недавно получил, и следовательно, он кажется отсутствовать культура их кто росли в богатстве.
Бамако	NOUN	OmegaWiki	Капитал Мали.
Евразия	NOUN	OmegaWiki	Самый большой суши на Земле, состоящий из Европы и Азии.
синий	ADJ	OmegaWiki	Несколько синий.
фломастер	NOUN	OmegaWiki	Авторучка с маленьким кончиком из войлока или фибры.
йол	NOUN	OmegaWiki	Маленькая лодка сделана чтобы грести с четырьмя или шестью вёслами.
Андорра-ла-Вьеха	NOUN	OmegaWiki	Столица и крупнейший город Андорры.
разговорный_русский	NOUN	OmegaWiki	Разновидность русского языка, используемая при устном общении.
согласиться	VERB	OmegaWiki	достичь соглашения, стать на одной волне с кем-то
арматура	NOUN	OmegaWiki	Железная палька. Может оказаться частью машиной, инструмента и т.п.
олениха	NOUN	OmegaWiki	Самка оленя.
качели	NOUN	OmegaWiki	конструкция для раскачивания из стороны в сторону
как	ADV	OmegaWiki	Каким образом?
краткосрочный	ADV	OmegaWiki	то, что скоро случится или закончится
таки-таки	NOUN	OmegaWiki	Креольский язык, на которых говорят в Суринаме.
наводнение	NOUN	OmegaWiki	стихинное бедствие из-за чрезвычайного роста уровня воды
Алжир	NOUN	OmegaWiki	Столица и крупнейший город Алжира.
хищник	NOUN	OmegaWiki	Зверь который убивает и есть других животных.
подразделение	NOUN	OmegaWiki	часть какой-то системы или организации
Дамаск	NOUN	OmegaWiki	Столица Сирии.
месяц	NOUN	OmegaWiki	Единственный естественный спутник Земли.
вожжа	NOUN	OmegaWiki	часть упряжи для управления лошадью
нувориш	NOUN	OmegaWiki	Богатый человек чей богатство он недавно получил, и следовательно, он кажется отсутствовать культура их кто росли в богатстве.
оборот	NOUN	OmegaWiki	сторона, которая не видно
халха-монгольский	NOUN	OmegaWiki	Официальный язык Монголии, тоже говорят в России.
неграмотность	NOUN	OmegaWiki	Неумение читать.
фара	NOUN	OmegaWiki	фары автомобиля, дающие максимально  дальнее освещение дороги
Амстердам	NOUN	OmegaWiki	Столица Нидерландов.
евроскептицизм	NOUN	OmegaWiki	Человек, у которого глубокие сомнения о целе и эффективносте Европейского союза.
олень	NOUN	OmegaWiki	Самка оленя.
Куров	NOUN	OmegaWiki	Поселок (село) в Польше, центр Курувcкой гмины Люблинского воеводства.
выборка_увеличенного_объема	NOUN	OmegaWiki	в маркетинге, это увеличенная выброка, которая представляет данные о собственном составе и о количестве людей, от которых будут происходить ответы. Этим пользуются чтобы иметь гарантию успеть провести социлологический опрос в необходимих рамках времени и объема.
тысячелетие	NOUN	OmegaWiki	Отрезок времени, равный 1000 годам.
Кингстон	NOUN	OmegaWiki	Столица Ямайки.
змея	NOUN	OmegaWiki	Пресмыкающееся из подотряда Змеи (Serpentes), обычно с чешуйчатым цилиндрическим телом без конечностей, глазами без подвижных век и подвижным соединением левой и правой частей челюстей, позволяющим заглатывать крупную добычу целиком.
общий	NOUN	OmegaWiki	Женский грамматический род слов.
эклер	NOUN	OmegaWiki	пирожное
приспособление	NOUN	OmegaWiki	процесс изменения товара, чтобы он был таким, каким он нужен клиентам
выполнять	VERB	OmegaWiki	полностью и правильно сделать какую-то работу
рабочий_контракт	NOUN	OmegaWiki	акт, которым кого-то принимают на работу
обходить	VERB	OmegaWiki	пойти вокруг некоего припятсвия, не подходя к нему непосредственно
дерево	NOUN	OmegaWiki	Большое деревянное растение с чётким стволом которым имеет ветви или листья в какое-то положение над землёй.
пополнить	VERB	OmegaWiki	внести деньги на счет
Федеративная_Республика_Германия	NOUN	OmegaWiki	Центральноевропейская страна со столицей в Берлине.
май	NOUN	OmegaWiki	Пятый месяц Григорианского календаря, с 31 днями.
мертворождение	NOUN	OmegaWiki	прерывание беременности
мед	NOUN	OmegaWiki	Вино, сделанное из меда.
Нью-Йорк	NOUN	OmegaWiki	Крупнейший город в штате Нью-Йорк и крупнейший город в Соединённых Штатах Америки.
парламент	NOUN	OmegaWiki	Семинар которого члены собирают чтобы обсуждать важные политические события дня и чтобы использовать власти правительства.
предел	NOUN	OmegaWiki	граница во времени иили пространстве и т.п.
земля	NOUN	OmegaWiki	Третья от Солнца планета Солнечной системы.
северной_Luri	NOUN	OmegaWiki	Язык Ирана
отец	NOUN	OmegaWiki	Мужской родитель.
подтверждать	NOUN	OmegaWiki	что-то доказать
осёл	NOUN	OmegaWiki	Домашний зверь, Equus asinus.
смерть	NOUN	OmegaWiki	Конец жизни; состояние.
африкаанс	NOUN	OmegaWiki	Западногерманский язык, на котором говорят преимущественно в Южно-Африканской республике и Намибии.
лист	NOUN	OmegaWiki	Одиночный прямоугольный кусок бумаги.
накопить	VERB	OmegaWiki	собрать больше количество чего-то
снести	VERB	OmegaWiki	намеренно разрушить какой-то построенный объект
арест	NOUN	OmegaWiki	заключение под стражу
фунт	NOUN	OmegaWiki	Официальная валюта Соединённого Королевства Соединённого Королевства Великобритании и Северной Ирландии и некоторые территории, с символом «£».
профессор	NOUN	OmegaWiki	Учитель или преподаватель в колледже или университете.
на_улице	ADV	OmegaWiki	На открытом воздухе, а не внутри здания.
усилитель	NOUN	OmegaWiki	устройство, которое увеличивает интенсивность электрического сигнала, чтобы сделать возможным передачу и получение 
зептомоль	NOUN	OmegaWiki	600 молекулы вещества. СИ знак: zmol.
Курув	NOUN	OmegaWiki	Поселок (село) в Польше, центр Курувcкой гмины Люблинского воеводства.
наклоняться	VERB	OmegaWiki	переходить от прямой к наклонной позиции
апрель	NOUN	OmegaWiki	Четвёртый месяц Григорианского календаря, с 30 днями.
хватать	VERB	OmegaWiki	взять способом крючка, когтей и т.п.
десятилетие	NOUN	OmegaWiki	Отрезок времени, равный десять годам.
хранилище	NOUN	OmegaWiki	складское помещение
Лондон	NOUN	OmegaWiki	Столица Соединённого Королевства и Англии.
комковатый	ADJ	OmegaWiki	Не гладкое; полное с комьями.
гладиаторский	ADJ	OmegaWiki	Имеющий отношение к гладиатору.
бабушка_со_стороны_отца	NOUN	OmegaWiki	Мать чей-то мать.
бабушка_со_стороны_отца	NOUN	OmegaWiki	Отец чей-то отец.
бабушка_со_стороны_отца	NOUN	OmegaWiki	Мать чей-то отец.
бабушка_со_стороны_отца	NOUN	OmegaWiki	Отец чей-то мать.
когда	ADV	OmegaWiki	В котором часу.
Свазиленд	NOUN	OmegaWiki	Страна в южной Африке которой столица Мбабане.
снежить	VERB	OmegaWiki	падать с неба в виде кристаллов
метод_отбора_проб	NOUN	OmegaWiki	в статистике. Часть, выбрана для того, чтобы показать поведение целого
балкон	NOUN	OmegaWiki	платформа, протягивающаяся вперед от внешней стены какой-то стройкиж обычно имеет переграду
юань	NOUN	OmegaWiki	Официальная валюта Китая.
Новый_год	NOUN	OmegaWiki	Традиционное желание на день нового года.
китайский_юань	NOUN	OmegaWiki	Официальная валюта Китая.
Люксембург	NOUN	OmegaWiki	Столица Люксембурга.
диамат	NOUN	OmegaWiki	Понятие бытия что все материальные вещи вызваны потому что есть раздор среди несовместимых властей, звеньев, и мнений.
боец	NOUN	OmegaWiki	Сражающийся, используя силу или оружие, обычно в рамках войска.
водоем	NOUN	OmegaWiki	низкой плозкость земли, где вода создала море
опора	NOUN	OmegaWiki	ертикальная поддержка в строительстве, в архитектуре
затопление	NOUN	OmegaWiki	стихинное бедствие из-за чрезвычайного роста уровня воды
строгость	ADJ	OmegaWiki	об аркитектурном стиле, что избегает лишнего, простой
бесплатный_сыр_бывает_только_в_мышеловке	NOUN	OmegaWiki	Пословица которая выражает мысль что это невозможное доставать без чего-то взамен.
Украина	NOUN	OmegaWiki	Страна в восточной Европе; столица Киев.
программа	NOUN	OmegaWiki	программное обеспечение, нацеленное на решение специфической проблемы.
показываться	VERB	OmegaWiki	Становиться видимым.
Тирана	NOUN	OmegaWiki	Столица и крупнейший город Албании.
партия	NOUN	OmegaWiki	Общественная организация, непосредственно ставящая перед собой задачи овладеть политической властью в государстве или принять в ней участие через своих представителей в органах государственной власти и местного самоуправления.
синеватый	ADJ	OmegaWiki	Несколько синий.
реальный_капитал	NOUN	OmegaWiki	капитал, представленный недвижимостью, производственным оборудованием и прочими подобными активами
снежный_человек	NOUN	OmegaWiki	Неизвестный зверь; часто сказан что он живёт в Гималаях.
Афганистан	NOUN	OmegaWiki	Страна в Средней Азии со столицой в Кабуле.
назначать	VERB	OmegaWiki	награждать кого-то чем-то
октябрь	NOUN	OmegaWiki	Десятый месяц Григорианского календаря, с 31 днями.
Марс	NOUN	OmegaWiki	Римский бог войны.
попытка	NOUN	OmegaWiki	продуманные действия для достижения какой-то цели
с_Новым_годом	NOUN	OmegaWiki	Традиционное желание на день нового года.
аннексия	NOUN	OmegaWiki	присоединение одной нации к другой
вечеринка	NOUN	OmegaWiki	Встреча людей (часто друзей или знакомых), в основном для развлечения и отдыха.
столетие	NOUN	OmegaWiki	Отрезок времени, равный 100 годам.
снос	NOUN	OmegaWiki	процесс намеренного разрушения какого-то построенного объекта
политическая_партия	NOUN	OmegaWiki	Общественная организация, непосредственно ставящая перед собой задачи овладеть политической властью в государстве или принять в ней участие через своих представителей в органах государственной власти и местного самоуправления.
латгальский	NOUN	OmegaWiki	Язык балтийской группы, на котором говорят латгальцы в Латгалии — восточной части Латвии.
британский_фунт	NOUN	OmegaWiki	Официальная валюта Соединённого Королевства Соединённого Королевства Великобритании и Северной Ирландии и некоторые территории, с символом «£».
йети	NOUN	OmegaWiki	Неизвестный зверь; часто сказан что он живёт в Гималаях.
поднять_вопрос	VERB	OmegaWiki	подходить к темеработевопросу
абхазский	NOUN	OmegaWiki	Северокавказский язык, распространённый преимущественно в Абхазии
дружелюбно	ADV	OmegaWiki	в дружеской манере
приобретение	NOUN	OmegaWiki	процесс покупки  услуг или товара
башкирский	NOUN	OmegaWiki	Тюркский язык, на котором говорят башкиры, проживающие в российской республике Башкортостан, а также в соседних Татарстане и Удмуртии.
голубой	ADJ	OmegaWiki	Несколько синий.
Белоруссия	NOUN	OmegaWiki	Государство в Восточной Европе.
свинина	NOUN	OmegaWiki	Мясо свиньи.
гуглить	VERB	OmegaWiki	Осуществлять поиск в Интернете с помощью Google.
Австрия	NOUN	OmegaWiki	Страна в Центральной Европе со столицой в Вене.
основной_капитал	NOUN	OmegaWiki	капитал, представленный недвижимостью, производственным оборудованием и прочими подобными активами
строительство	NOUN	OmegaWiki	Процесс постройки.
молодой	ADJ	OmegaWiki	Находящийся в начале жизни, проживший мало времени.
антропоморфизм	NOUN	OmegaWiki	Наделение человеческими свойствами нечеловеческих существ, предметов, явлений природы или идей.
род	NOUN	OmegaWiki	Женский грамматический род слов.
водосбор	NOUN	OmegaWiki	низкой плозкость земли, где вода создала море
закутывать	VERB	OmegaWiki	быть везде вокруг
найлучшим_образом	NOUN	OmegaWiki	как можно лучше
русский	NOUN	OmegaWiki	Язык восточно-славянской группы, на котором говорят преимущественно в России и республиках бывшего СССР.
закрытый_бассейн	NOUN	OmegaWiki	Плавательный бассейн в здании.
задача	NOUN	OmegaWiki	цель
волшебник	NOUN	OmegaWiki	Тот, кто занимается магией, колдовством.
дедушка_по_матери	NOUN	OmegaWiki	Отец чей-то отец.
дедушка_по_матери	NOUN	OmegaWiki	Мать чей-то мать.
дедушка_по_матери	NOUN	OmegaWiki	Отец чей-то мать.
дедушка_по_матери	NOUN	OmegaWiki	Мать чей-то отец.
приглашать	VERB	OmegaWiki	Спросить за присутствие или участие кого-то.
абитуриентка	NOUN	OmegaWiki	Человек кто обращается к университет или колледж.
танк	NOUN	OmegaWiki	Бронированная боевая машина на гусеничном ходу с мощным пушечным вооружением.
сранан-тонго	NOUN	OmegaWiki	Креольский язык, на которых говорят в Суринаме.
строительная_работа	NOUN	OmegaWiki	Процесс постройки.
джинсы	NOUN	OmegaWiki	Брюки из денима, что популярная неформальная одежда вокруг света.
мультипликация	NOUN	OmegaWiki	кинематографическая техника, приводящая в движение рисунки
горячий	ADJ	OmegaWiki	С высокой температурой.
январь	NOUN	OmegaWiki	Первый месяц Григорианского календаря, с 31 днями.
здесь	ADV	OmegaWiki	Это место.
закрытый_плавательный_бассейн	NOUN	OmegaWiki	Плавательный бассейн в здании.
атеизм	NOUN	OmegaWiki	Точка зрения, согласно которой не существует Бога или богов.
свойство	NOUN	OmegaWiki	характерная черта
полночь	NOUN	OmegaWiki	Середина ночи; 24 часа.
коллега	NOUN	OmegaWiki	Товарищ, который оказывает помощь.
зимовать	VERB	OmegaWiki	Проводить зимнее время (в данном месте).
синтаза	NOUN	OmegaWiki	Энзим, который катализирует процесс синтеза.
Вилли	NOUN	OmegaWiki	Племянники Дональда Дака.
